AnnotationHub	bc
apcluster	cran
AUCell	bc
BiocFileCache	bc
BiocSingular	bc
bluster	bc
celldex	bc
dendextend	cran
GSEABase	bc
pheatmap	cran
rebook	bc
robustbase	cran
scater	bc
scran	bc
scRNAseq	bc
scuttle	bc
SingleR	bc
Seurat	cran
sigclust	cran
hdf5r	cran
meshr	bc
meshes	bc
devtools	cran
biomaRt	bc
rhdf5	bc
HGNChelper	cran
openxlsx	cran
data.tree	cran
RSQLite	cran
remotes	cran
ComplexHeatmap	bc
BiocGenerics	bc
DelayedArray	bc
DelayedMatrixStats	bc
limma	bc
lme4	bc
S4Vectors	bc
SingleCellExperiment	bc
SummarizedExperiment	bc
batchelor	bc
HDF5Array	bc
terra	bc
ggrastr	bc
AUCell	bc
RcisTarget	bc
GENIE3	bc
zoo	bc
mixtools	bc
rbokeh	bc
DT	bc
NMF	bc
ComplexHeatmap	bc
R2HTML	bc
Rtsne	bc
doMC	bc
doRNG	bc
dittoSeq	bc
circlize	cran
clusterProfiler	bc
org.Hs.eg.db	bc
org.Mm.eg.db	bc
org.Rn.eg.db	bc
org.Dm.eg.db	bc
org.At.tair.db	bc
org.Dr.eg.db	bc
org.Sc.sgd.db	bc
org.Ce.eg.db	bc
org.Bt.eg.db	bc
org.Gg.eg.db	bc
org.Mmu.eg.db	bc
org.Ss.eg.db	bc
org.Cf.eg.db	bc
org.EcK12.eg.db	bc
org.Xl.eg.db	bc
org.Pt.eg.db	bc
org.Ag.eg.db	bc
org.EcSakai.eg.db	bc
scry	bc
TFBSTools	bc
DESeq2	bc
MAST	bc
ggdendro	cran
harmony	cran
multtest	bc
metap	cran

